**XXXXXXXXXXXXXXXXXX
X***********XX*****X
XX*XXX*X*XXXX**X*XXX
XXXX*XXX******XX***X
X*X***XX*XXXX*XXX*XX
X***X*******XXX*XXXX
XX*XXX*XX*X**X*****X
XXXX*X*XX*XX***XX*XX
XX******X*X**XXXXXXX
X**XXX*XX*XX*XXX*X*X
XXXXXX**XXXX*******X
X******XX****XX*XXXX
XX*XX*XX**X*XX****XX
X**XX**XX*XXXXX*X**X
X*XX**XXX****XX*XXXX
X**XX***X*X*XX*****X
XXXX**X*XXX**XXX*XXX
X****XX**XX*XX*****X
XX*X**XX*XX**XX*XX*X
XXXXXXXXXXXXXXXXXX**
